20 20
11111111111111111111
10000000000000000001
10433333333400043331
10400000000400040001
10400000000400040001
10400000000000043331
104000000000000000+1
10400000000433333301
10400000000000000001
10400000000000000001
10400000000000000001
10400000000000000001
10400000000000000001
10433330003333340001
10000000000000043331
10000000000000000001
10000000000000000001
10433333333333330001
10000000000000000001
111111111111111111x1

