20 30
111111111111111111111111111111
100000000000000000000000000001
133333333334000433333333340001
100000000000000400000000040001
100000000000000400000000040001
134004333333333400000000040001
100004000000000000000000040001
10000400000000+000000000040001
100004000000000000000000000001
100004333300000000000000000001
100000000000000000003333333331
100000000000000000000000000001
133333333300000000000000000001
100000000000000000000000000001
100000000000000000000000000001
100000000333333333333333333331
1000000000000x0000000000000001
100000000000000000000000000001
100000000000000000000000000001
111111111111111111111111111111