20 40
1111111111111111111111111111111111111111
1040000000000000000000000000000000000001
1040000000000004333333334000000000000001
1043333333333334000000004000000000000001
1000000000000004000000004000000000000001
1333333333333404000000000000000000000001
1000000000000404000000000000000000000001
1000000000000404333333333333333340000001
1000000000000400000000000000000+40000001
1000000000000404333333333333333340000001
1000000000000404000000000000000000000001
1000000000000404333333333340000000000001
1000000000000404000000000040000000000001
1000433333333404333333333340000000000001
1000400000000004000000000000000000000001
1000404333333333000000000000000000000001
100040433333333333333333x400000000000001
1000400000000000000000000400000000000001
1000400000000000000000000400000000000001
1111111111111111111111111111111111111111